{
  "data":[4, 4, 1, 7, 1, 4, 4,
    4, 4, 4, 4, 4, 4, 4,
    4, 4, 4, 4, 4, 4, 4,
    4, 2, 4, 4, 4, 2, 4,
    4, 6, 2, 14, 2, 9, 4,
    4, 2, 4, 4, 4, 2, 4,
    4, 19, 4, 10, 4, 19, 4,
    4, 4, 4, 5, 4, 4, 4,
    4, 4, 4, 5, 4, 4, 4,
    4, 13, 4, 13, 4, 5, 8],
  "height":10,
  "width":7
}