{
  "data":[2, 2, 2, 2, 2, 2, 2,
    2, 8, 2, 2, 2, 8, 2,
    2, 2, 8, 2, 8, 2, 2,
    2, 2, 10, 2, 10, 2, 2,
    2, 9, 13, 2, 13, 9, 2,
    2, 2, 2, 2, 2, 2, 2,
    18, 2, 2, 2, 10, 2, 18,
    2, 6, 2, 2, 2, 6, 2,
    0, 2, 19, 8, 19, 2, 0,
    13, 10, 13, 14, 13, 10, 13],
  "height":10,
  "width":7
}