{
  "data":[8, 2, 2, 2, 2, 2, 8,
    3, 2, 3, 2, 3, 2, 3,
    8, 2, 2, 2, 2, 2, 8,
    3, 3, 3, 2, 3, 3, 3,
    19, 2, 2, 14, 2, 2, 19,
    3, 2, 3, 2, 3, 2, 3,
    3, 2, 3, 2, 3, 2, 3,
    3, 2, 3, 2, 3, 2, 3,
    8, 2, 3, 3, 3, 2, 8,
    14, 14, 14, 19, 14, 14, 14],
  "height":10,
  "width":7
}